0 8542 8548 8563 8570 8587 8598 8608 8610 8617 8628 8638 8640 8643 8644 8654 8658 8660 8678 8689 8702 8706 8712 8713 8720 8723 8725 8726 8727 8744 8752 8761 8783 8810 8818 8819 8831 8836 8861 8865 8868 8872 8882 8892 8897 8917 8918 8927 8948 8969 8985 8988 8989 8990 8992 8998 9006 9008 9010 9014 9020 9022 9028 9042 9050 9064 9065 9077 9088 9089 9092 9095 9096 9112 9118 9127 9131 9134 9138 9156 9184 9188 9190 9192 9209 9220 9227 9235 9242 9243 9248 9249 9251 9264 9282 9287 9294 9295 9302 9303 9307 9317 9328 9345 9355 9356 9357 9365 9367 9369 9370 9378 9397 9407 9417 9427 9428 9437 9438 9441 9443 9462 9467 9475 9490 9506 9509 9517 9525 9546 9550 9553 9575 9576 9577 9606 9611 9622 9630 9637
1 8540 8541 8543 8551 8558 8560 8569 8572 8575 8579 8581 8582 8584 8586 8589 8592 8593 8594 8596 8600 8601 8602 8603 8605 8606 8607 8609 8611 8612 8613 8625 8626 8627 8634 8636 8637 8645 8648 8650 8652 8661 8677 8680 8685 8687 8688 8692 8693 8694 8697 8699 8700 8703 8705 8709 8715 8717 8718 8719 8728 8734 8738 8742 8747 8748 8749 8750 8762 8766 8767 8788 8789 8790 8792 8795 8797 8801 8804 8805 8808 8812 8813 8814 8816 8822 8823 8825 8826 8832 8833 8841 8842 8845 8853 8857 8859 8878 8880 8883 8893 8898 8903 8904 8910 8912 8913 8919 8920 8928 8930 8933 8937 8941 8952 8957 8959 8960 8966 8968 8972 8973 8974 8977 8979 8983 9001 9019 9021 9027 9030 9034 9036 9043 9044 9046 9047 9056 9073 9075 9081 9082 9086 9111 9113 9120 9126 9128 9136 9139 9140 9142 9145 9146 9154 9159 9162 9165 9166 9170 9177 9180 9182 9191 9193 9197 9201 9204 9208 9212 9215 9217 9218 9219 9223 9225 9228 9230 9233 9245 9247 9253 9257 9258 9259 9260 9262 9265 9268 9270 9273 9274 9276 9292 9293 9297 9298 9300 9301 9304 9306 9319 9321 9325 9331 9332 9335 9337 9339 9340 9341 9343 9348 9349 9351 9360 9368 9372 9377 9381 9384 9387 9392 9396 9403 9408 9409 9411 9420 9421 9423 9425 9426 9433 9440 9442 9448 9449 9453 9457 9458 9468 9471 9479 9480 9486 9491 9496 9497 9500 9507 9508 9510 9513 9514 9515 9516 9521 9523 9527 9533 9534 9537 9540 9541 9542 9551 9554 9555 9559 9560 9565 9570 9571 9574 9584 9588 9590 9598 9603 9608 9610 9613 9615 9617 9620 9623 9626 9633 9634
2 8539 8545 8546 8550 8553 8556 8557 8559 8562 8571 8577 8585 8588 8591 8595 8597 8604 8614 8615 8616 8618 8621 8623 8630 8631 8632 8635 8641 8653 8657 8666 8671 8672 8673 8682 8695 8696 8701 8721 8722 8724 8729 8743 8745 8753 8755 8759 8773 8776 8779 8780 8784 8815 8837 8839 8840 8846 8847 8849 8850 8851 8858 8860 8870 8873 8876 8877 8881 8887 8888 8894 8895 8901 8906 8909 8915 8916 8922 8924 8929 8942 8946 8961 8963 8967 8970 8971 8975 8981 8993 8997 9002 9003 9007 9015 9031 9037 9038 9051 9053 9057 9059 9061 9068 9069 9071 9074 9087 9090 9094 9097 9114 9121 9122 9129 9143 9148 9157 9158 9161 9167 9168 9169 9174 9183 9194 9198 9199 9206 9210 9213 9214 9216 9221 9222 9237 9241 9252 9266 9267 9271 9275 9279 9280 9283 9284 9286 9291 9296 9299 9305 9308 9318 9327 9334 9338 9342 9346 9350 9362 9371 9375 9376 9382 9385 9389 9390 9391 9393 9398 9405 9416 9419 9422 9429 9431 9434 9439 9444 9446 9447 9450 9454 9463 9464 9466 9470 9472 9476 9477 9478 9481 9484 9485 9487 9492 9494 9501 9519 9529 9530 9532 9543 9544 9545 9548 9556 9558 9563 9564 9567 9569 9578 9581 9583 9586 9591 9592 9600 9601 9602 9607 9614 9616 9621 9627 9628 9632 9635
3 8544 8547 8549 8552 8554 8561 8564 8566 8567 8568 8619 8622 8624 8639 8642 8646 8647 8649 8655 8659 8662 8665 8667 8669 8670 8674 8675 8681 8683 8686 8690 8704 8708 8710 8714 8731 8733 8735 8737 8746 8754 8757 8758 8760 8764 8765 8770 8771 8772 8777 8778 8781 8786 8787 8793 8796 8799 8800 8802 8806 8809 8811 8827 8828 8830 8838 8844 8852 8854 8855 8864 8867 8884 8885 8886 8891 8896 8899 8900 8902 8905 8907 8908 8911 8914 8921 8923 8925 8934 8935 8936 8938 8939 8943 8944 8945 8949 8951 8954 8955 8956 8958 8964 8976 8978 8987 8991 8994 8995 9000 9004 9005 9011 9012 9013 9017 9018 9023 9024 9025 9029 9032 9033 9035 9040 9041 9045 9048 9049 9052 9054 9060 9062 9066 9067 9070 9076 9080 9083 9084 9091 9093 9099 9102 9103 9105 9107 9108 9109 9115 9116 9124 9130 9132 9133 9135 9137 9141 9147 9152 9153 9155 9160 9163 9171 9172 9176 9179 9187 9195 9200 9205 9207 9211 9226 9231 9234 9236 9239 9240 9246 9254 9261 9269 9272 9277 9278 9281 9285 9289 9309 9310 9313 9314 9316 9320 9322 9324 9326 9330 9333 9336 9347 9352 9353 9354 9358 9359 9361 9363 9364 9373 9379 9380 9383 9386 9394 9395 9400 9401 9402 9404 9406 9410 9412 9413 9414 9424 9430 9451 9455 9456 9459 9460 9465 9473 9483 9488 9489 9498 9499 9502 9503 9505 9511 9512 9520 9522 9524 9528 9531 9535 9538 9547 9552 9557 9562 9566 9568 9572 9573 9580 9582 9585 9587 9589 9595 9596 9597 9599 9605 9618 9619 9624 9625 9629 9631 9636 9638
4 8555 8565 8573 8574 8576 8578 8580 8583 8590 8599 8620 8629 8633 8651 8656 8663 8664 8668 8676 8679 8684 8691 8698 8707 8711 8716 8730 8732 8736 8739 8740 8741 8751 8756 8763 8768 8769 8774 8775 8782 8785 8791 8794 8798 8803 8807 8817 8820 8821 8824 8829 8834 8835 8843 8848 8856 8862 8863 8866 8869 8871 8874 8875 8879 8889 8890 8926 8931 8932 8940 8947 8950 8953 8962 8965 8980 8982 8984 8986 8996 8999 9009 9016 9026 9039 9055 9058 9063 9072 9078 9079 9085 9098 9100 9101 9104 9106 9110 9117 9119 9123 9125 9144 9149 9150 9151 9164 9173 9175 9178 9181 9185 9186 9189 9196 9202 9203 9224 9229 9232 9238 9244 9250 9255 9256 9263 9288 9290 9311 9312 9315 9323 9329 9344 9366 9374 9388 9399 9415 9418 9432 9435 9436 9445 9452 9461 9469 9474 9482 9493 9495 9504 9518 9526 9536 9539 9549 9561 9579 9593 9594 9604 9609 9612 9639
